###############
#@#######     #
#   #   #  #  #
##  # # #  #  #
##    # ## # ##
#######  # #  #
#      # # ## #
# ###    # #  #
#   ###### # ##
##         #  #
###############
