########     #
#  #   #  #  #
#  # # #  #  #
#    # ## # ##
######  # #  #
      # # ## #
 ###    # #  #
   ###### # ##
#         #  #
##############
