###############
## f f ########
##f#f#f########
#fffffff#######
# #f#f# 012 X##
#fffffff#######
##f#f#f########
## f f ########
###############
###############
