##############
##     X    ##
#  10        #
#  2f    f   #
#    $       #
#    $#####  #
#  ########  #
#  ########  #
#$$########$$#
##############
