#############
##         ##
#           #
#    210 X  #
#    3#     #
#           #
#  #$   $#  #
#   $       #
#   $$#$    #
#     @     #
#       #   #
#      ##   #
#      ##   #
#$$$$$$$$$$$#
#############

